NO assets/textures/snow.png
SO assets/textures/diamond.png
WE assets/textures/sand.png
EA assets/textures/grass.png

C 0,87,183
F 255,215,0

        1111111111111111111111111
        1000000000000010000000001
        10000000000001 1000000001
        1000000000000010000000001
11111111101100000111000E000000001
100011100011000001110111111111111
100000000000000000000000000011111
10000000011000000000000000001
100000001  100000000000000001
100000001  100000000000000001
10000000011000000001010010001
11000000000000000000011000111
10000000000000000000000000001
1111111111111111111111111111111





